1. 포트스캔
 - advanced port scanner
 - masscan - 대량 IP 포트 스캔
 - nmap, zenmap - 포트스캔
 - viewdns.info/portscan - 온라인 포트스캐너

 
2. 웹 스캔, 캡처
 - amass - 서브도메인 스캐너
 - foca - SQL Server에서 URL 정보만으로 서브 도메인 및 정보 수집
 - gobuster - 웹사이트 디렉토리 및 하위 도메인 브루트 포싱, 숨겨진 디렉 찾기
 - httrack website copier - 웹사이트 카피 툴
 - httpscreenshot - 웹사이트 스크린샷 및 소스코드 캡쳐
 - knockpy - 서브도메인 스캐너
 - subfinder - 서브도메인 스캐너


3. 웹 프록시, 해킹, 기타
 - burpsuite
 - eyewitness - 정보수집 서버의 결과 관리
 - gitrob - 깃허브 민감정보, 파일 탐색
 - oralyzer - open redirect 가능성 테스트
 - paros - 웹 프록시
 - seclists - 사전, 레인보우 테이블 모음
 - sqlmap - SQLi 자동화
 - wfuzz - 웹 퍼징 도구
 - ysoserial - Java 직/역직렬화 취약점 개념 증명 도구
 - ZAP - 웹 스캔, 프록시, 해킹
 - caido - 웹 취약점 스캔 자동화 도구
 - metasploit


4. 시스템
 - nessus - 시스템 보안 취약점 스캔
 - nikto - 웹 서버 취약점
 - Valgrind - 메모리 디버깅
 - AddressSanitizer - 런타임 메모리 오류 검사


5. 자료수집
 - dumpit / winpmem - 메모리 덤프
 - KAPE - 아티팩트 크롤, 추출
 - live response collect - 실시간 모든 휘발성 데이터
 - ntfs log tracker - NTFS 포맷 파싱


6. 파일 변환
 - audacity - 소리를 이미지로 변환
 - il2cppdumper - .so를 C# 변환
 - dex2jar - dex를 jar 변환
 - apktool - apk를 java 변환


7. 파일 분석
 - 010 editor - HEX 상세 분석
 - dive - Docker 분석
 - event log explorer - 윈도우 이벤트로그 분석
 - exiftool - 사진 메타 정보
 - fl studio - 소리파일 분석
 - forevid - 비디오 프레임 단위 추출 가능
 - hxd - HEX 분석
 - kakaodecrypt - 카카오톡 DB 분석
 - LECmd - 링크파일 분석
 - lnk parser - 링크파일 메타데이터
 - networkminer - 네트워크 패킷 분석
 - RBCmd - 휴지통 파일 역추적, 분석
 - REGA - 웹 히스토리 분석
 - registry explorer - 레지스트리 분석 GUI / 아티팩트 분석
 - registry log analysis - 레지스트리 정리 및 데이터 통합
 - regripper - 레지스트리 분석 CLI
 - sqlite3 - SQLite DB
 - SSView - 한글 악성코드 분석
 - sysinternals suite - 윈도우 분석
 - tcpdump - 네트워크 패킷 덤프
 - treesize free - 디렉토리 나열
 - volatility - 메모리 분석
 - wireshark - 네트워크 패킷 분석
 - winprefetchview - Prefetch 분석
 - winsearchDBanalyzer - 윈도우 Search 분석
 - jd-gui - jar파일 분석
 - jadx - apk 디컴파일
 - cuckoo sandbox - 악성코드 샌드박스
 - db browser for sqlite


8. 리버싱
 - detectiteasy - 파일 종류, 패킹여부
 - ghidra - 디스어셈블러
 - IDA - 디스어셈블러
 - ilspy - 디컴파일러
 - peid, petools, peview
 - pwndbg
 - x32, x64 - 윈도우용 디버거
 - one_gadget - david942j의 oneshot gadget


9. 포렌식
 - autopsy - 포렌식 분석
 - forensic explorer - 포렌식 분석
 - ftk imager - 디스크 이미징
 - regcool - 레지스트리 편집기
 - santoku - 모바일 포렌식 전용 OS
 - encase
 - analyzeMFT - mft 데이터 추출
 - imhex


A. 라이브러리
 - pwntools (shellcraft) - Python 포너블 필수 모듈
 - rsactftool - Python RSA 분석


B. 기타
 - CPUID HWM - 하드웨어 정보
 - GIMP - 그림판++
 - GNS3 - VM 토폴로지
 - Redisinsight - Windows GUI Redis
 - thunderbird - 메일
 - Sans window_forensic_analysis_poster - 포렌식 참고자료
 - windows-forensic-artifacts - 윈도우 포렌식 참고자료
